########################################
#......................................#
#.E..S.................................#
#..........+............+..............#
#......................................#
##############################.........#
#......................................#
#......................................#
#.......############################...#
#..................................#...#
#..........+...+.....+.......+...+.#.E.#
#..................................#...#
#...............########################
#...#############......................#
#...#................................+.#
#...#...........................#......#
#...#....####...#...............########
#...#.......#...#.......+.......#+.....#
#...#..+.+..#...#......................#
#...##..#####...#......................#
#...##..#...#...#...............####...#
#...#.......#...#.................+....#
#...#....+..#...#...################...#
#...#.......#...#..................#...#
#...#########...#............+.....#...#
#...............#..................#.E.#
#...............#..................#...#
########################################
