########################################
#......................................#
#...S..................................#
#......................................#
#......................................#
#......................................#
#......................................#
#........................+.............#
#.......+..............................#
#......................................#
#.................####....##############
#.................#++#.................#
#.................#++#.................#
#############.....#..#.................#
#......................................#
#.........................+............#
#......................................#
#...........#..........................#
#...........#..........................#
#....+......#..........................#
#...........#..........................#
#...........#................E.........#
#...........#..........................#
#......................................#
#......................................#
#......................................#
#......................................#
########################################
