########################################
#......................................#
#......................................#
#................................S.....#
#......................................#
################################.......#
#......................................#
#......................................#
#......................................#
#...############################.......#
#...#..................................#
#...#..................................#
#...#..................................#
#...#..................................#
#...#....#######################.......#
#...#....#.............................#
#...#....#.............................#
#...#....#.............................#
#...#....#.............................#
#...#....#.............................#
#...#....#.....#################.......#
#...#....#.....#.......................#
#...#....#.....#.......................#
#...#....#.....#..##############.......#
#......................................#
#......................................#
#......................................#
#......................................#
########################################
