########################################
#......................................#
#.......+..............+...............#
#.............+..................S.....#
#......................................#
################################.......#
#......................................#
#......................+............+..#
#......................................#
#...############################.......#
#...#..................................#
#...#..................................#
#...#..................+...............#
#...#..................................#
#...#....#######################.......#
#...#....#.............................#
#...#....#.............................#
#...#....#.............+.........+.....#
#...#....#.............................#
#...#....#.............................#
#...#....#.....#################.......#
#...#....#.....#.......................#
#...#....#.....#.......................#
#...#....#.....#..##############.......#
#......................................#
#...E..................................#
#.......+......................+.......#
#......................................#
########################################
