########################################
#......................................#
#.S.................................E..#
#....#......+....+....+................#
#....#.................................#
#.E..#.................................#
####################################...#
#..................................#...#
#.............................+....#...#
#..................................#...#
#..................................#...#
#....##########....###.............#...#
#....#........#......###############...#
#....#..+.+...#...............#........#
#....#...+....#...............#........#
#....#........############....#........#
#....#...######..........#....#....#...#
#....#...#...............#....#....#...#
#....#...#################....#....#...#
#....#........................#....#...#
#....#........................#....#...#
#....#........................#....#...#
#....##########################....#...#
#..................................#...#
#................+.................#...#
#....+.............................#.E.#
#..................................#...#
########################################
